ABC	USA	ABRACADABRA FARM
ABE	USA	ABE LINCOLN DOWNS
AC	USA	(AGUA) CALIENTE
ACE	USA	RUNNING ACES
AD	USA	ARIZONA DOWNS
ADC	USA	ADAMS COUNTY FAIRGROUNDS
ADS	USA	ADENA SPRINGS FARM
AEF	USA	"ANOTHER EPISODE FARM, INC."
AF	USA	LARAMIE DOWNS
AHP	USA	ARROWHEAD PARK
AHT	USA	ATLANTA HALL TRAINING CENTER
AIK	USA	AIKEN
AJX	CAN	AJAX DOWNS
AKD	USA	AKRON DOWNS
AKI	USA	AKINDALE TRAINING CENTER
AKS	USA	AK-SAR-BEN
ALB	USA	ALBUQUERQUE
ALD	USA	ALDILA FARM
ALI	USA	ALLIANCE
ALL	USA	SANDILLO RACETRACK
ALM	USA	ALMEDA DOWNS
ALQ	USA	AL-QUOZ
ALZ	USA	ALAZAN TRAINING CENTER
ANF	USA	ANTHONY DOWNS
AP	USA	ARLINGTON PARK
APS	USA	APISA FARM
AQU	USA	AQUEDUCT
ARA	USA	AURORA
ARP	USA	ARAPAHOE PARK
ASC	USA	ASCOT PARK
ASD	CAN	ASSINIBOIA DOWNS
ASF	USA	ALL SEVEN FARM
ASH	USA	ASHWELL STABLES
ATH	USA	ATLANTA
ATL	USA	ATLANTIC CITY
ATO	USA	HORSEMEN'S ATOKAD DOWNS
AUD	USA	AUDUBON PARK
AVN	USA	AVON
BB	CAN	BLUE BONNETS
BBT	USA	BO-BETTA RACETRACK
BC	USA	BREEDERS CUP
BCF	USA	BROWN COUNTY FAIR
BD	USA	BERKSHIRE DOWNS
BDW	USA	BRIDLEWOOD FARM
BEL	USA	BELMONT PARK
BEU	USA	BEULAH PARK
BF	USA	BROCKTON FAIR
BFL	USA	BUFFALO MEADOWS
BGD	USA	PLAYERS BLUEGRASS DOWNS
BHT	USA	BLACK HILLS TURF CLUB
BIL	USA	BILLINGS
BIR	USA	BIRMINGHAM TURF CLUB
BKF	USA	BLACK FOOT
BKR	USA	BUCKRAM OAK TRAINING CENTER
BLR	USA	BEL AIR
BLS	USA	BLAYLOCK SOUTH
BLT	USA	BRADFORD LANE TRAINING CENTER
BLV	USA	BELVOIR TRAINING CENTER
BM	USA	BAY MEADOWS
BMF	USA	BAY MEADOWS FAIR
BML	USA	BALMORAL PARK
BMT	USA	BEAUMONT RACETRACK
BND	USA	BANDERA DOWNS
BNT	USA	Benton Training Center
BOI	USA	LES BOIS PARK
BON	USA	BONITA FARM
BOW	USA	BOWIE
BOX	USA	BOX ELDER COUNTY FAIR
BOZ	USA	BOZEMAN
BRA	USA	BRAY RANCH RACETRACK
BRD	USA	BLUE RIBBON DOWNS
BRK	USA	B.R.I.N.C.
BRN	USA	HARNEY COUNTY FAIR
BRO	USA	BROOKHILL FARM
BRS	USA	BURNS RACING STABLE
BRT	USA	Brutus Proj.
BRV	USA	BRAZOS VALLEY
BSC	USA	SAWYER DOWNS
BSD	USA	BLUESTEM DOWNS
BTB	USA	BIGHEART THOROUGHBREDS
BTC	USA	Braeburn
BUF	USA	BUCHANAN FARM
BUR	USA	BURWELL RACETRACK
CAM	USA	CAMDEN
CAS	USA	CASSIA COUNTY FAIR
CAW	USA	CARTER WALSH FARM
CBQ	USA	CHABBOQUESSET TRAINING CENTER
CBT	USA	CANYON BREEZE TRAINING CENTER
CBU	USA	GOLDEN SPIKE CHARIOT RACING
CBV	USA	CABIN VIEW FARM
CBY	USA	CANTERBURY PARK
CCF	USA	CUSTER COUNTY FAIR
CCT	USA	THE TRAINING CENTER AT COPPER CROWNE
CD	USA	CHURCHILL DOWNS
CDA	USA	COEUR D'ALENE
CDH	USA	CARDINAL HILL
CDT	USA	CHURCHILL TRAINING
CEG	CAN	CALGARY
CEN	USA	CENTENNIAL RACE TRACK
CF	USA	CHANCELAND FARM
CHA	USA	CHARLESTON
CHL	USA	CHARLOTTE
CHM	USA	CHAMPAGNE FARM
CI	USA	CONEY ISLAND
CIM	USA	CIMARRON FARM
CJW	USA	JACKSON HOLE CHARIOT RACING
CKA	USA	CAHOKIA DOWNS
CKG	USA	COCKAIGNE DOWNS
CLA	USA	CLARENCE DOWNS
CLD	USA	CLAREMORE DOWNS
CLF	USA	"CLOVERLEAF FARMS II, INC."
CLG	CAN	TROUT SPRINGS TRAINING CENTER
CLM	USA	CLEMMONS
CLS	USA	COLUMBUS
CM	USA	CLASSIC MILE
CMB	USA	CUMBERLAND COUNTY FAIRGROUNDS
CMF	USA	CALUMET FARM TRAINING CENTER
CMW	USA	COMMONWEALTH RACE COURSE
CNL	USA	COLONIAL DOWNS
CNR	USA	CANYON ROAD TRAINING CENTER
CNS	USA	COLTS NECK STABLES
COL	USA	COLFAX RACETRACK
COM	USA	COMMODORE DOWNS
CON	USA	CONCORD TRACK
COR	USA	CORONA SQUA-BA TRACK
COU	USA	WEBER DOWNS CHARIOT RACES
COW	USA	COWBOY PARK
CP	CAN	CONNAUGHT PARK
CPI	USA	POCATELLO DOWNS CHARIOT RACES
CPW	USA	CHIPPEWA DOWNS
CR	USA	CRABTREE
CRA	USA	COLUMBINE PARK
CRC	USA	CALDER RACE COURSE
CRG	USA	PCQHA/CALIFORNIA RODEO GROUNDS
CRN	USA	CRANWOOD PARK
CRT	CAN	COCHRANE RACETRACK
CRU	USA	"CRUPI'S NEW CASTLE FARM, INC."
CSB	USA	CASTLEBROOK TRAINING CENTER
CSF	USA	COLORADO STATE FAIR
CSR	USA	CASTLE ROCK
CT	USA	HOLLYWOOD CASINO AT CHARLES TOWN RACES
CTC	USA	CAMPTOWN TRAINING CENTER
CTS	USA	CLOUSTON TRAINING CENTER
CTT	USA	CAIN'S THOROUGHBRED TRAINING CENTER
CWF	USA	CENTRAL WYOMING FAIR
CWL	USA	CUMBERLAND
CWS	USA	CROWN'S WAY SOUTH
DAD	USA	DADE PARK
DAN	USA	DARBY DAN FARM TRAINING CENTER
DAR	USA	DARBY DOWNS
DAY	USA	DAYTON
DCD	USA	DEL CAMINO DOWNS
DD	USA	DIAMOND D RANCH
DDF	USA	DOUBLE DIAMOND FARM AND TRAINING CENTER
DDR	USA	DIAMOND D RANCH
DDT	USA	DERBY DAYS TRAINING CENTER
DEC	USA	DESMOND CASTLE
DED	USA	DELTA DOWNS
DEL	USA	DELAWARE PARK
DEP	CAN	DESERT PARK
DEQ	USA	LITTLE RIVER DOWNS
DET	USA	DETROIT RACE COURSE
DEV	USA	DEVONSHIRE DOWNS
DG	USA	COCHISE COUNTY FAIR @ DOUGLAS
DIX	USA	DIXIE DOWNS
DLF	USA	DRAGONS LYRE FARMS
DLT	USA	DELTA DOWNS (St. Joseph)
DMC	USA	DMC TRAINING CENTER
DMF	USA	DEL MAR FAIR
DMR	USA	DEL MAR
DND	USA	DON DEE FARM
DON	USA	DONIDA TRAINING CENTER
DOV	USA	DOVER DOWNS
DPF	USA	DIAMOND P FARM
DR	USA	DEL RIO
DSW	USA	Del Mar Satelite Wagering
DTC	USA	DELENY TRAINING CENTER
DTD	USA	DARE TO DREAM FARM
DTR	USA	DELTA TRAINING CENTER
DUB	USA	DUBAI RACING
DUE	USA	DUELING GROUNDS
DUF	CAN	DUFFERIN PARK
DUN	USA	GREENELEE COUNTY FAIR @ DUNCAN
DUQ	USA	DU QUOIN
DUR	USA	NARROW GAUGE DNS/NAVAJO TRAILS FSTA
DUX	USA	DUELING GROUNDS SIMULCAST
DVD	USA	DAVIS DOWNS
DVP	CAN	DORVAL PARK
DWM	USA	DREAM WITH ME STABLES
DXD	USA	DIXIE DOWNS
DYR	USA	DERBY RUN TRAINING CENTER
ECF	USA	ELMORE COUNTY FAIR
ECL	USA	ECLIPSE FARM
ECR	USA	ELK CREEK RANCH
ECT	USA	EAST CAROLINA TRAINING CENTER
ED	USA	ENERGY DOWNS
EDM	CAN	EDMONTON
EDT	USA	EMPRESS DOWNS TRAINING CENTER
EIS	USA	EISAMAN TRAINING CENTER
EKA	USA	EKALAKA
ELK	USA	ELKO COUNTY FAIR
ELL	USA	ELLOREE TRAINING CENTER
ELM	USA	ELMA
ELP	USA	ELLIS PARK
ELY	USA	WHITE PINE RACING
EMD	USA	EMERALD DOWNS
EME	USA	EMERALD PASTURES TRAINING CENTER
EMP	USA	EMPIRE CITY
EMT	USA	EMMETT
END	USA	GARFIELD DOWNS
ENO	CAN	ENOCH RACETRACK
EP	CAN	EXHIBITION PARK
EPD	USA	EL PASO DOWNS
EPF	USA	EAGLE POINT FARM
EPR	USA	EL PRIMERO TRAINING CENTER
EQ	USA	EQUIBASE
EQB	USA	EQUIBASE MEDIA PP'S
ERD	USA	ERIE DOWNS
ERM	CAN	ERMINESKIN RACETRACK
ETC	USA	ECLIPSE TRAINING CENTER
EUR	USA	EUREKA
EVD	USA	EVANGELINE DOWNS
EVN	USA	EVANSTON
EVR	USA	EVERGREEN TRAINING CENTER
EVT	USA	EVANGELINE TRAINING CENTER
EWT	USA	EDDIE WOODS TRAINING CENTER
EXP	CAN	MOOSE JAW EXPOSITION
FAI	USA	FAIR HILL
FAR	USA	NORTH DAKOTA HORSE PARK
FAX	USA	FAIRFAX
FAY	USA	VERNA LEA FARMS
FB	USA	CHOUTEAU COUNTY FAIR
FBF	USA	FOX BROWN FARM
FCF	USA	FALLON COUNTY FAIRGROUNDS
FCL	USA	FAIRCLOTH TRAINING CENTER
FD	USA	FLORIDA DOWNS
FE	CAN	FORT ERIE
FER	USA	FERNDALE
FFM	USA	FOLK FARM
FG	USA	FAIR GROUNDS
FGS	USA	FAIRGROUNDS SPEEDWAY
FH	USA	FAR HILLS
FL	USA	FINGER LAKES
FLG	USA	FLAGSTAFF
FM	USA	FORT MIAMI
FMT	USA	FAIR MEADOWS
FNO	USA	FRESNO
FOF	USA	505 FARM TRAINING CENTER
FOL	USA	FOLSOM TRAINING CENTER
FON	USA	FONNER PARK
FOX	USA	FOXBORO
FP	USA	FAIRMOUNT PARK
FPF	USA	FORT PLAINS FARM
FPL	USA	FAIR PLAY PARK
FPP	USA	FAIRPLAY PARK
FPX	USA	FAIRPLEX PARK
FRF	USA	FRANKS FARM
FRN	USA	FRONTERA TRAINING CENTER
FRO	USA	FROST TRAINING CENTER
FRP	USA	FRONTIER PARK
FRR	USA	FOUR ROSES THOROUGHBREDS
FS	USA	COCONINO COUNTY FAIR
FTC	USA	FLA. TRAINING CTR.
FTD	USA	FT. DUNCAN RACETRACK
FTP	USA	FORT PIERRE
FX	USA	FOXFIELD
FXP	USA	FOX POINT FARM
GAD	USA	GATOR DOWNS
GAL	USA	SACRAMENTO COUNTY FAIR
GBF	USA	GREAT BARRINGTON FAIR
GCF	USA	GILA COUNTY FAIR
GD	USA	GALWAY DOWNS
GDC	USA	GOOD CHANCE FARM
GDF	USA	GARYDALE FARM TRAINING CENTER
GF	USA	GREAT FALLS
GG	USA	GOLDEN GATE FIELDS
GHF	USA	GOLDEN HARP FARM
GIL	USA	GILLESPIE COUNTY FAIRGROUND
GIV	USA	GIVENS TRAINING CENTER
GLD	USA	GREAT LAKES DOWNS
GLF	USA	GREAT LAKES FAIR TRAINING FACILITY
GLM	USA	GOLDMARK
GLN	USA	GLYNDON
GLP	USA	THE GALLOPS TRAINING CENTER
GLW	USA	GLENWOOD TRAINING CENTER
GM	USA	GREEN MOUNTAIN
GMP	USA	GRESHAM PARK
GN	USA	GRAND NATIONAL
GND	USA	GLENDALE DOWNS
GNN	USA	GUNN FARM
GP	USA	GULFSTREAM PARK
GPF	USA	GENUINE PLEASURE FARM
GPR	CAN	GRANDE PRAIRIE
GRA	USA	GREEN ACRES
GRB	USA	GRABO TURF CLUB
GRD	CAN	GREENWOOD
GRE	USA	MULTNOMAH COUNTY FAIR
GRM	USA	GREAT MEADOW
GRP	USA	GRANTS PASS
GRS	USA	GARRISON FARM
GS	USA	GARDEN STATE PARK
GTC	USA	GREENTREE TRAINING CENTER
GTW	USA	GATEWAY DOWNS
GV	USA	GENESEE VALLEY
HAG	USA	HAGERSTOWN
HAM	CAN	HAMILTON (ONT)
HAN	USA	KING COUNTY FAIRGROUNDS
HAP	USA	HARBOR PARK
HAR	USA	HIPODROMO ARGENTINO DE PALERMO
HAW	USA	HAWTHORNE
HBF	USA	HOBEAU FARM
HBH	USA	"HUNTER BROOK HORSE FARM, INC."
HCF	USA	HUMBOLDT COUNTY FAIR
HD	USA	HILLTOP DOWNS
HDG	USA	HAVRE DE GRACE
HDT	USA	H & D TRAINING CENTER
HER	USA	HERITAGE FARM TRAINING CENTER
HF	USA	HART FARM
HGF	USA	HENLY GRANGE FARM
HHC	USA	HURRICANE HALL TRAINING CENTER
HIA	USA	HIALEAH PARK
HID	USA	HILOMA DOWNS
HIG	USA	HIGH GATE FARM
HIL	USA	SHAMROCK DOWNS
HLN	USA	HELENA DOWNS
HLP	USA	KENTUCKY HELPHUNTERS
HML	USA	HACIENDA MOLTAQUA RACETRACK
HMP	USA	HORSEMAN'S PARK
HOB	USA	NAVAJO COUNTY FAIR
BHP	USA	HOLIDAY DOWNS
HOD	USA	HOLLYWOOD PARK
HOO	USA	HOOSIER PARK
HOU	USA	SAM HOUSTON RACE PARK
HP	USA	HAZEL PARK
HPF	USA	"HOOPER FARMS, INC."
HPO	USA	HORSEMEN'S PARK
HPT	USA	HIGHPOINT FARM AND TRAINING CENTER
HR	CAN	HIGH RIVER FAIRGROUNDS
HRF	USA	HAWKINRIDGE FARM                                  
HRT	USA	BLUE VALLEY RANCH RACETRACK
HS	USA	HOT SPRINGS
HSD	USA	HOOSIER DOWNS
HST	CAN	HASTINGS RACECOURSE                               
HTF	USA	HICKORY TREE FARM TRAINING CENTER
HTG	USA	HERITAGE PARK
HUF	USA	HUNTER FARM TRAINING CENTER
HVD	USA	HIDDEN VALLEY DOWNS
HWK	USA	HAWKS RIDGE TRAINING CENTER
HYT	USA	HYATT FARM AND TRAINING CENTER
IAF	USA	IRISH ACRES FARM
IMP	USA	IMPERIAL
INC	USA	INCOMPASS                                         
IND	USA	INDIANA DOWNS
ING	USA	INGLESIDE
INT	USA	International Simulcast
ISF	USA	INDIANA STATE FAIR
ITC	USA	INFIELDS TRAINING CENTER
JAM	USA	JAMAICA
JDF	USA	JOE DAN FARM
JDM	USA	JDM TRAINING CENTER
JEF	USA	JEFFERSON PARK
JHF	USA	JORDAN'S HORSE FARM
JND	USA	JEFFERSON DOWNS
JOU	USA	JOURNEYS END TRAINING CENTER
JRM	USA	JEROME COUNTY FAIR
JUA	USA	JUAREZ
JUB	USA	JUBILEE FARM
JUN	USA	JUNCTION RACETRACK
JVR	USA	J V RANCH
KAM	CAN	KAMLOOPS
KBD	USA	KING BEE DOWNS
KC	USA	KING CITY FAIR
KD	USA	KENTUCKY DOWNS
KEE	USA	KEENELAND
KEP	CAN	KENILWORTH PARK
KEY	USA	KEYSTONE RACE TRACK
KHC	USA	KENTUCKY HORSE CENTER
KIN	CAN	KIN PARK
KLF	USA	KLAMATH COUNTY FAIR
KNF	USA	KINSMAN FARM
KRE	USA	KREMMLING
KSP	USA	KALISPELL
KTC	USA	KENNINGTON TRAINING CENTER
KTH	USA	KATHER DOWNS
KYR	USA	KENTUCKY RACEWAY
LA	USA	LOS ALAMITOS
LAD	USA	LOUISIANA DOWNS
LAG	USA	LA GRANGE DOWNS
LAM	USA	LA MESA PARK
LAR	USA	NUEVO LAREDO
LAT	USA	LATONIA
LAV	USA	LAS VEGAS PARK
LAZ	USA	LAZY E TRAINING CENTER
LB	CAN	LONG BRANCH
LBD	USA	LA BAHIA DOWNS
LBG	CAN	LETHBRIDGE
LBT	USA	LAUREL BROWN RACETRACK
LD	USA	LINCOLN DOWNS
LDD	USA	LITTLE DIXIE DOWNS
LEB	USA	LEBANON
LEV	USA	LITTLE EVERGLADES
LEX	USA	LEXINGTON
LF	USA	LINCOLN FIELDS
LGA	USA	LONGACRES
LGF	USA	LEGACY FARM
LIB	USA	LIBERTY BELL PARK
LIF	USA	L.I.F.E. DOWNS
LIG	USA	LIGONIER
LIT	USA	LITTLE BROOK TRAINING CENTER
LLA	USA	LLANGOLLEN TRAINING CENTER
LMB	USA	LAMBHOLM SOUTH TRAINING CENTER
LNN	USA	LINCOLN RACE COURSE
LOF	USA	LONE OAK FARM
LOM	USA	LOMPOC VALLEY TRACK
LOS	USA	LIVE OAK STUD
LP	USA	LAS PALMAS
LP	CAN	LANSDOWN PARK
LPP	USA	LA PUENTE PARK
LRL	USA	LAUREL PARK
LS	USA	LONE STAR PARK
LSB	USA	LONESTAR PARK BETTOR TIMES
LTC	USA	LUBBOCK TRAINING CENTER
LUB	USA	LUBBOCK DOWNS
LV	USA	PITTMAN PARK RACETRACK
LVT	USA	LAKE VIEW TRAINING CENTER
LXG	USA	KY ASSOC. COURSE
LYD	CAN	LLOYDMINISTER AGRI EXHIBITION ASSOC.
LZD	USA	LINZAY DOWNS
MAD	USA	MADISON
MAF	USA	MARIAS FAIR
MAL	USA	MALVERN
MAN	USA	MANOR DOWNS
MAR	USA	MARLBORO
MAS	USA	MASON-DIXON
MAU	USA	MAUMEE DOWNS
MBF	USA	MCKATHAN BROTHERS FARM
MBK	USA	MEADOWBROOK TRAINING CENTER                       
MBO	USA	MIDDLEBORO FAIR
MC	USA	MILES CITY
MCF	USA	MARION COUNTY FAIR
MCH	USA	MITCHELL
MCR	USA	MOFFAT COUNTY RACETRACK
MCU	USA	MCCUTCHEN TRAINING CENTER
MD	CAN	MARQUIS DOWNS
MDA	CAN	MELVILLE DISTRICT AGRIPAR
MDE	USA	MEADE
MDL	USA	MEADOWLARK DOWNS
MDY	USA	Meadowlands Alternate
MEC	CAN	MEADOW CREEK
MED	USA	MEADOWLANDS                                       
MEH	CAN	MEDICINE HAT EXPOSITION
MEM	USA	MEMORIAL PARK
MEP	USA	METRAPARK
MER	USA	MERCURY EQUINE CENTER
MF	USA	MARSHFIELD FAIR
MFT	USA	MCKATHAN FARM TRAINING CENTER
MGM	USA	GREER DOWNS
MGO	USA	MARENGO PLANTATION
MHF	USA	MT. HOLLY FARM TRAINING CENTER
MI	USA	MIDWAY DOWNS
MID	USA	MIDDLEBURG
MIH	USA	MIAMI HORSEMEN'S ASSOCIATION TRAINING CENTER
MIL	CAN	MILLARVILLE
MIM	USA	MIAMI
MJC	USA	Maryland Jockey Club
MKF	CAN	MARKHAM & EAST YORK AGRI SOCIETY
MLO	CAN	MILO RACE TRACK
MM	USA	MISSOURI MEADOWS
MME	USA	MARLYN MEADOWS
MMR	USA	MAGNA DOWNS
MND	USA	MIDLAND DOWNS
MNR	USA	MOUNTAINEER CASINO RACETRACK & RESORT             
MOF	USA	MOHAVE COUNTY FAIR
MOG	USA	MOMENT OF GLORY TRAINING CENTER
MOH	CAN	MOHAWK
MOL	USA	MOLINE
MON	USA	MONKTON
MOR	USA	MORVEN PARK
MP	USA	MILES PARK                                        
MPD	USA	MAPLEWOOD DOWNS
MPL	USA	MAPLE HEIGHTS
MPM	USA	MT. PLEASANT MEADOWS
MRD	USA	MARBLE DOWNS
MRT	USA	MARTINSVILLE FAIRGROUNDS
MRY	USA	MERRYLAND FARM
MSF	USA	MICHIGAN STATE FAIR
MSK	USA	MUSKINGHAM COUNTY FAIR
MSS	USA	MARTIN STABLE SOUTH
MST	USA	MID SOUTH TRAINING
MTC	USA	MIDDLETOWN TRAINING CENTER
MTH	USA	MONMOUTH PARK
MTP	USA	MONTPELIER
MTT	USA	MIDDLETOWN TRAINING TRACK
MTX	USA	MINSHALL TRAINING CENTER
MTY	USA	Monmouth Alternate
MUS	USA	MUSKEGON
MWB	USA	MEADOWBROOK TRAINING CENTER
MWF	USA	MAYO WEST FARM
MYF	USA	MAYFAIR TRAINING CENTER
NAD	USA	NAD AL SHEBA
NAR	USA	NARRAGANSETT PARK
NBS	USA	NIALL BRENNAN STABLES
ND	USA	NASSAU DOWNS
NET	USA	NEW EPISODE TRAINING CENTER
NGD	USA	NARROW GUAGE DOWNS
NHF	USA	NEW HAVEN FARM
NJF	USA	"NELSON JONES FARMS AND TRAINING CENTER, INC."
NMP	USA	NORTHAMPTON
NP	CAN	NORTHLANDS PARK
NPR	USA	NAPIER'S TRAINING CENTER
NS1	USA	ATLANTIC CITY NSA                                 
NS2	USA	COLONIAL NSA
NS3	USA	KEENELAND NSA
NS4	USA	MONMOUTH NSA
NS5	USA	PENN NATIONAL NSA
NS6	USA	PHILADELPHIA PARK NSA
NS7	USA	BELMONT NSA
NS8	USA	SARATOGA NSA
NS9	USA	DELAWARE NSA
NTC	USA	NOBLES TRAINING CENTER
NWF	USA	NEW FARM TRAINING CENTER
NY	USA	NEW YORK STATE FAIRGROUNDS
NYR	USA	New York Racing Office
OEC	USA	OAKRIDGE EQUINE CENTER
OHC	USA	OCALA HORSE FARM COMPLEX
OJO	USA	OCALA JOCKEY CLUB TRAINING CENTER
OKL	USA	OAKLEAF TRAINING CENTER
OKR	USA	OAK RIDGE
OLY	USA	OLYMPIC HILL TRAINING CENTER
OMA	USA	OMAHA
ONE	USA	ONEIDA COUNTY FAIR
ONT	USA	ONTARIO FAIRGROUNDS
OP	USA	OAKLAWN PARK
OPX	USA	OAKLAWN PARK SIMULCAST
ORT	USA	ORTING TRAINING CENTER
OSA	USA	OAK TREE AT SANTA ANITA
OTC	USA	OCALA TRAINING CENTER
OTD	USA	OAK TREE AT DEL MAR
OTF	USA	OCALA THOROUGHBRED FARMS
OTH	USA	OAK TREE AT HOLLYWOOD PARK
OVR	USA	OVERBROOK TRAINING CENTER
OW	CAN	OLD WOODBINE
OWT	USA	OCALA WEST TRAINING FACILITY
OXF	USA	OXFORD TRAINING CENTER
OXM	USA	OXMOOR
OZD	USA	OZARK DOWNS
PAF	USA	PARADISE FARM TRAINING CENTER
PAL	USA	PALATKA
PAR	USA	PARR MEADOWS
PAW	USA	OSAGE DOWNS
PAY	USA	PAYSON PARK TRAINING CENTER
PBD	USA	PALM BEACH DOWNS
PCF	USA	PINK CROWN FARMS
PCN	USA	PECAN PARK
PDA	USA	PADUA TRAINING CENTER
PDL	USA	PONCE DE LEON
PEG	USA	PEGASUS THOROUGHBRED TRAINING CENTER
PEN	USA	PENN NATIONAL
PER	USA	PERFENICK FARM
PHA	USA	PARX RACING AT PHILADELPHIA PARK
PHO	USA	PHOENIX FAIRGROUNDS
PHT	USA	PLEASANT HILLS TRAINING CENTER
PIC	CAN	PICOV DOWNS
PID	USA	PRESQUE ISLE DOWNS
PIM	USA	PIMLICO
PIN	USA	PINAL COUNTY FAIR
PIT	USA	PITT PARK
PJ	USA	PARK JEFFERSON
PJT	USA	"PAUL JONES TRAINING CENTER, TULAROSA"
PLA	USA	PLAYFAIR
PLM	USA	PALM MEADOWS TRAINING CENTER
PLN	USA	PLEASANTON
PLP	USA	PLEASANT PASTURE FARM
PLP	CAN	POLO PARK
PM	USA	PORTLAND MEADOWS
PMB	USA	PALM BEACH POLO CLUB                              
PMF	USA	PORTLAND MEADOWS FAIR
PMM	USA	PALM MEADOWS TRAINING CENTER
PMT	USA	PINE MTN-CALLAWAY GARDEN                          
PND	USA	PENDLETON FAIRGROUNDS
PNL	USA	PINNACLE RACE COURSE
PNS	USA	PENINSULA FARM
PNY	USA	PINEYWOODS DOWNS
POC	USA	POCONO DOWNS
POD	USA	POCATELLO DOWNS
POM	USA	POMONA
PPK	USA	POMPANO PARK
PPM	USA	PIKES PEAK MEADOWS
PPX	USA	PLEASANT PASTURE FARM
PRE	USA	PRESCOTT DOWNS
PRK	USA	PARKWAY DOWNS
PRM	USA	PRAIRIE MEADOWS
PRO	USA	PROSPECT
PRP	USA	PIT RUN PARK
PRV	USA	CROOKED RIVER ROUNDUP
PRX	USA	PARX RACING AT PHILADELPHIA PARK
PSP	USA	(PHOE) SPORTSMANS PARK
PTC	USA	POST TIME TRAINING CENTER
PTF	USA	PAULSON RANCH TRAINING CENTER
PTT	USA	PALMETTO THOROUGHBRED TRAINING CENTER
PW	USA	PERCY WARNER
PYF	USA	PLUMLEY FARMS
QBY	CAN	QUEENSBURY DOWNS
QCD	USA	QUAD CITY DOWNS
QD	USA	QUEEN CITY DOWNS (QH TRACK)
QRF	USA	QUAIL RUN FARM
QWF	USA	QUIET WOMAN FARM TRAINING CENTER
QWS	USA	QUIET WOMAN FARM SOUTH
RAC	USA	RACELAND
RAI	USA	RAINIER DOWNS
RAN	USA	RANDALL PARK
RAP	USA	RAPID CITY
RAT	USA	RACEWAY PARK
RAV	USA	RAVALLI COUNTY FAIR
RB	USA	RED BANK
RBT	USA	RED BOB TRAINING FACILITY
RCE	USA	RACING EDGE TRAINING CENTER
RCF	USA	RICHFIELD COUNTY FAIR
RD	USA	RIVER DOWNS
RDA	CAN	WESTERNER EXH. ASSOC.
RDE	USA	RED EARTH TRAINING CENTER
RDM	USA	RED MILE
RDP	CAN	RED DEER PARK
REB	USA	REBER RANCH TRAINING TRACK
RED	USA	REDLANDS
REG	CAN	REGINA
REN	USA	RENO RACETRACK
RET	USA	RETAMA PARK
RFD	USA	RICHFIELD DOWNS
RIF	USA	WESTERN SLOPE RACE ASSOC
RIG	USA	RIGBIE FARM
RIL	USA	RILLITO
RIM	USA	RIMROCK MEADOWS
RIS	USA	RISING SUN FARM
RKM	USA	ROCKINGHAM PARK
RKV	USA	ROCKY VALLEY
RM	USA	ROSS MEADOWS
RMF	USA	R & M FARMS
RMT	USA	ROSS MEADOWS
RND	USA	RAINBOW DOWNS
ROD	USA	ROSS DOWNS
ROF	USA	RED OAK FARM
ROL	USA	ROLLING OAK FARM
ROP	USA	ROUND UP PARK
RP	USA	REMINGTON PARK
RP1	USA	REMINGTON PARK RACING OFFICE
RPD	CAN	ROSSBURN PARKLAND DOWNS
RQH	USA	RQHS Mile
RRD	USA	RIMROCK DOWNS
RRR	USA	RIO RITA RACETRACK
RSD	USA	RIVERSIDE DOWNS
RSS	USA	RISING SUN STABLE
RST	USA	RETTLE SPRINTLAND TRAINING CENTER
RUI	USA	RUIDOSO DOWNS
RUP	USA	MINIDOKA COUNTY FAIR @ RUPERT
RVP	USA	RIVER POINT TRAINING CENTER
RWD	USA	ROLLIE WHITE DOWNS
S11	USA	Monterrico Peru
SA	USA	SANTA ANITA PARK
SAB	USA	SABINE FARM
SAC	USA	SACRAMENTO
SAF	USA	GRAHAM COUNTY FAIR @ SAFFORD
SAG	USA	SAGEBRUSH DOWNS
SAL	USA	SALEM
SAM	USA	SAM-SON FARM
SAN	CAN	SANDOWN PARK
SAR	USA	SARATOGA
SAS	USA	SAGE AND SAND TRAINING CENTER
SAS	CAN	SASKATOON
SAY	USA	LEGION PARK
SBA	USA	STONEBRIDGE ANNEX
SBF	USA	"SHADYBROOK FARM, INC."
SBG	USA	STONEBRIDGE TRAINING CENTER
SCD	USA	SCARBOROUGH DOWNS
SCF	USA	SUNNY CLIME FARM
SCL	USA	SANTA CLARA COUNTY FAIRGROUNDS
SCN	USA	SCANLON TRAINING CENTER
SCT	USA	SANDERS CREEK TRAINING CENTER
SCW	USA	SC WAY RACING STABLES
SDD	USA	SANDY DOWNS (1968)
SDF	USA	CENTRAL STATES FAIR
SDY	USA	SANDY DOWNS
SED	USA	SEDALIA
SEM	USA	SEMINOLE DOWNS
SEO	USA	SEARCH ENGINE OPTIMIZATION
SER	USA	SERENDIPITY FARM
SFC	USA	SOUTH FLORIDA TROTTING CENTER
SFE	USA	SANTA FE
SFT	USA	SUNNYSIDE FARM TRAINING CENTER
SGC	USA	STARTING GATE TRAINING CENTER
SGF	USA	SAGAMORE FARM
SH	USA	STRAWBERRY HILL
SHA	USA	SHANBALLY ACRES
SHD	USA	SHENNANDOAH DOWNS
SHF	USA	SILVERTON HILL FARM
SHW	USA	SHAWAN DOWNS
SHY	USA	SHELBY DOWNS
SJ	USA	APACHE COUNTY FAIR @ ST. JOHNS
SJD	USA	SAN JUAN DOWNS
SJM	USA	ST. JAMES
SKI	USA	SKI HI PARK
SKL	USA	SKY'S THE LIMIT
SKY	USA	SKYLIGHT TRAINING CENTER
SLC	USA	UTAH STATE FAIRGROUNDS
SLR	USA	SAN LUIS REY DOWNS
SLV	USA	SILVER PARK
SM	USA	SUFFOLK MEADOWS
SMT	USA	SUMMERTREE TRAINING CENTER
SNA	USA	SONORA PARK
SND	CAN	SUNFLOWER
SOL	USA	SOLANO
SON	USA	SANTA CRUZ COUNTY FAIR @ SONOITA
SOP	USA	SOUTHERN PINES
SOT	USA	SILVER OAKS TRAINING CENTER
SP	USA	SUNSHINE PARK
SP0	USA	Santiago Chile
SP1	USA	Keeneland Special Daily Double
SP2	USA	Hipodromo Chile Chile
SP3	USA	Valparaiso Chile
SP4	USA	La Plata Argentina
SP5	USA	San Isidro Argentina
SP6	USA	Palermo Argentina
SP7	USA	Longchamp                                         
SP8	USA	Maronas Uruguay
SP9	USA	International
SPC	USA	STARTING POINT TRAINING CENTER
SPG	USA	ILLINOIS STATE FAIR
SPL	USA	Special                                           
SPS	USA	SUPERIOR STABLES
SPT	USA	SPORTSMAN'S PARK
SPV	USA	SPRINGVALLEY TRAINING CENTER
SQC	USA	SQUAW CREEK DOWNS
SR	USA	SANTA ROSA
SRD	USA	SUWANNEE RIVER DOWNS
SRP	USA	SUNRAY PARK
SRS	USA	SUNRISE TRACK
SSD	USA	SUNSET DOWNS
SST	USA	SUNRISE STABLE SOUTH
SSX	USA	SAGE AND SAND TRAINING CENTER
STA	CAN	BLOOD RESERVE RACETRACK
STB	USA	STONEBRIDGE FARM
STC	USA	SALLISAW EQUINE TRAINING CENTER
STF	USA	STARSFELL FARM
STK	USA	STOCKTON
STL	USA	ST LOUIS
STN	USA	STONEYBROOK AT FIVE POINTS
STO	USA	STONY OAK TRAINING CENTER
STP	CAN	STAMPEDE PARK
STS	USA	SIESTA SUN TRAINING CENTER
STU	USA	STUTTS STABLE
STW	USA	STONEWALL FARM
SUD	USA	SUN DOWNS
SUF	USA	SUFFOLK DOWNS
SUN	USA	SUNLAND PARK
SUT	USA	SUTHERLAND FARM
SWB	USA	SWEET BRIAR TRAINING CENTER
SWF	USA	SWEETWATER COUNTY FAIR
SWH	USA	SWEETWATER HORSE TRACK AND TRAINING CENTER
SWT	USA	SANDY WOODS TRAINING CENTER
SYC	USA	SYCAMORE TRAINING CENTER
SYL	USA	SYLMAR FARM
SYR	USA	ARKANSAS DOWNS
TAM	USA	TAMPA BAY DOWNS
TAN	USA	TANFORAN
TAP	USA	TAPETA FARM
TAT	USA	T & A TRAINING CENTER                             
TBD	USA	THUNDERBIRD DOWNS
TBL	USA	TIMBERLAKE FARM
TC	USA	TRAINING CENTER
TCF	USA	TRUMBULL COUNTY FAIR
TCP	USA	THUNDERCLOUD PARK
TCT	USA	TOWN AND COUNTRY TRAINING CENTER
TDN	USA	THISTLEDOWN
TDS	USA	Track Data Test
TFT	USA	Tiffany Farms Training Center
TGD	USA	TIOGA DOWNS
THA	USA	THAYER COUNTY FAIR
THF	CAN	THORNCLIFFE PARK (ONT)
TIL	USA	TILLAMOOK COUNTY FAIR
TIM	USA	TIMONIUM
TIO	USA	TIOGA PARK
TIP	USA	TIPTON RACETRACK
TOP	USA	TOPSFIELD FAIR
TOW	USA	UTE MOUNTAIN/UTE TRIBE
TP	USA	TURFWAY PARK
TR2	USA	Truform test 2
TRB	USA	Thoroughbred Racing Protective Bureau
TRM	USA	TRINITY MEADOWS
TRO	CAN	TROCHU
TRP	USA	TROPICAL PARK
TRS	USA	TRI-STATE PARK
TRT	USA	THUNDER RANCH TRAINING CENTER
TRU	USA	Truform test
TRY	USA	TRYON
TS	CAN	TROUT SPRINGS
TSF	USA	TRACKSIDE FARM
TST	USA	TRUE SOUTH TRAINING CENTER
TTC	USA	THE THOROUGHBRED CENTER
TUC	USA	TUCSON
TUL	USA	TULARE COUNTY FAIR
TUP	USA	TURF PARADISE
UD	USA	URANIUM DOWNS
UJC	USA	UMPAQUA JOCKEY CLUB
UN	USA	EASTERN OREGON LIVESTOCK SHOW
UNI	USA	PENNSYLVANIA HUNT CUP                             
UVA	USA	UVALDE RACETRACK
VAL	USA	VALHALLA FARMS
VAN	USA	VANATTA TRACK AND TRAINING CENTER
VCF	USA	VALLEY COUNTY FAIR
VEG	CAN	VEGRIVILLE AGRICULTURAL SOCIETY
VES	USA	VESSELS RANCH RACETRACK
VF	USA	VICTORIA FARM
VHT	USA	VICTORY HAVEN TRAINING CENTER
VIC	USA	VICTORVILLE
VIN	USA	VINERY STABLE
VLN	USA	VALENTINE
VQF	USA	VICTORY QUEST FARM
VS	USA	VIRTUAL STABLE
VV	USA	VAL VERDE DOWNS
WAC	USA	WASHINGTON COUNTY FAIRGROUNDS
WAR	USA	WARRENTON
WAS	USA	WASHINGTON PARK
WAT	USA	WATERFORD PARK
WAV	USA	WABASH VALLEY DOWNS
WAW	USA	WILE A WAY FARM
WBR	USA	WEBER DOWNS
WCD	USA	WELLS CO FAIR
WCF	USA	WADENA COUNTY FAIR
WCT	USA	WEBB CARROLL TRAINING CENTER
WDB	USA	WOODBROOK FARM
WDS	USA	THE WOODLANDS
WEW	USA	WEST WIND FARM
WEY	USA	WEYMOUTH FAIR
WFR	USA	WILD FALCON RANCH
WH	USA	WINDY HILLS T.C.
WHE	USA	WHEELING DOWNS
WHL	USA	WHEELER TRAINING STATION
WIL	USA	WILLOWDALE STEEPLECHASE
WIN	CAN	WINDSOR RACEWAY
WKE	USA	WILKIE DOWNS
WKY	USA	WEST KY THOROUGHBRED TRAINING CENTER
WLN	USA	WALNUT HALL
WM	USA	WILLISTON MILE
WMF	USA	WESTERN MT FAIR
WND	USA	WINDING OAKS FARM
WNT	USA	WINTERTHUR
WO	CAN	WOODBINE
WOC	USA	WOODS CREEK TRAINING CENTER
WOD	USA	WOODSIDE RANCH
WOR	USA	WOODSTOCK RANCH
WPR	USA	WHITE PINE RACEWAY
WRC	USA	W R TRAINING CENTER
WRD	USA	WILL ROGERS DOWNS
WRT	USA	WINDY RIDGE TRAINING CENTER
WSF	USA	WESFIELD FARM
WSR	USA	WINSTAR TRAINING CENTER
WST	USA	WESTAMPTON FARMS
WTC	USA	WEBSTER TRAINING CENTER
WTS	USA	WAITSBURG RACE TRACK
WW	USA	WALLA WALLA
WXF	USA	WEXFORD FARM
WYO	USA	WYOMING DOWNS
XTC	USA	XALAPA TRAINING CENTER
YAV	USA	YAVAPAI DOWNS
YD	USA	YELLOWSTONE DOWNS
YKT	CAN	YORKTON EXH. ASSOC.
YM	USA	YAKIMA MEADOWS
YMA	USA	YUMA COUNTY FAIR
ZIA	USA	ZIA PARK

